
13
   ####  #####
####  ####   #
# $  $     $ ####
# #   # ### #   #
#  $   $ # $$ $ #
###  ## $@$     ##
  #$ ##  # $$ $$ #
  #    $  ## ##  #
 ### #$##  ...# ##
 #  ..*.*..##.# #
 # #..*.....*.# #
 #   ########   #
 #####      #####
10
   #####
  ##  @####
  #  #$$  #
###.#   # #
#  $#.#$  #
#   ...  ##
###$#.#$ #
  #     ##
  ###   #
    #####
10
   ####
####  #
#     ####
# $ #  . ##
#  #   .  #
## #$$#.  #
##    #####
# @ ###
#   #
#####
9
    ####
 ####  #
## $   #
#  # #$#
#.@.   ##
## # #  #
 #      #
 #  #####
 ####

9
#### ####
#  ###  #
#  # $$ #
# $$ #  #
#    #  ##
### $.#  #
  #..*.@.#
  ##   ###
   #####
10
   #####
   #   #
#### # #
# . .# #
#  .   #
# .## $##
##  #$$ #
 ##   $@#
  ##  ###
   ####
10
###### ####
#    ###  #
# *     * #
## #***#  #
 #  *+*  ##
## #*$*# ##
#  # # #  #
#         #
#  ########
####
11
 #####
 # + #
 #$.$#
 # * #
 # * #
## * #
#  * ##
#  *  #
#  *  #
###  ##
  ####
10
   #####
  ##  @####
  #  #$$  #
###.#   # #
#  $#.#$  #
#   ...  ##
###$#.#$ #
  #     ##
  ###   #
    #####
10
####
#  ###
#    #
# $  #
### ###
# $ $ #
#..@..#
#  $  #
###  ##
  ####
10
   #####
   #   #
#### # #
# . .# #
#  .   #
# .## $##
##  #$$ #
 ##   $@#
  ##  ###
   ####
10
       #####
     ###   #
    ## . # #
   ##  $$  #
  ## *$. ###
 ## $  ###
## .$. #
#  @ ###
#  . #
######
8
#####
#  @####
#  $.  #
###$.# #
#  $.# #
# #$.  #
#    ###
######


7
 #######
 #     #
 # .$. #
## $@$ #
#  .$. #
#      #
########
7
####
# .#
#  ###
#*@  #
#  $ #
#    #
######
8
 #####
 #   #
##$# ###
#   $@ #
# #  # #
# #. . #
#   ####
#####

6
########
#      #
# .**$@#
#      #
#####  #
    ####

8
  ####
 ##  #
## . ##
#@$$$ #
#. .# #
# #   #
#   ###
#####
  

10
    #####
   ##   ##
  ## .#  #
 ##   @  #
##    #  #
#  $ #####
# * ##
#  ##
####

8
  #####
###   #
# $ # ##
# #  . #
#    # #
## #   #
 #@  ###
 #####


 
 
Easy

5
##########
#        #
#  $  +  #
#        #
##########

11
 ###########
 #         #
 #         #
 #  . . .  #
 #    $    #
 #    $    #
 #    $    #
 #         #
 #    @    #
 #         #
 ###########

7
#######
# .   #
# # # #
# # # #
# $@  #
#     #
#######

8
########
#  . . #
#    # #
## # # #
 #  $  #
 #  $@ #
 #     #
 #######
 
Freeze deadlock

5
#######
# $ ..#
#  $  #
#     #
#######

Moderate

7
####
# .#
#  ###
#*@  #
#  $ #
#  ###
####
 
6
 #####
 #@  ##
 #.$* #
 #  # #
 #    #
 ######
 
 
 6
 ######
 #@   ##
 # $$  #
 # #. .#
 #     #
 #######
 

7
   ####
 ###  #
 #@ .$##
 #   $ #
 # #.  #
 #     #
 #######
 

 6
 ########
 #      #
 # .**$@#
 #      #
 #####  #
    ####
    
12    
  ######
  # ..@#
  # $$ #
  ## ###
   # #
   # #
#### #
#    ##
# #   #
#   # #
###   #
  #####
  
6  
####
#  ####
# . . #
# $$#@#
##    #
 ######
 

Really hard!

10
 #########
 #   *   #
 # ## ## #
 #  * *  #
###  #  ###
#  .$#$.  #
# #  @  # #
#  .$#$.  #
###  #  ###
  #######
  
10
####
#  #########
#    ##    #
# $$$#     #
##...# #$$$#
 #...# #...#
 #$$$  #...##
 #    ##$$$ #
 ####### @  #
       ######
       
INSANE

17
 #############################
 #         *   *   *         #
 #  $ ### $  #####  $ ### $  #
 # $ $ ### $  ###  $ ### $ $ #
 #*#  $ ### $  #  $ ### $  #*#
 # ## .*.*.*.*.$.*.*.*.*. ## #
 # ###$ $ $ $ $.$ $ $ $ $### #
## ..*.....*...$...*.....*.. ##
##  $ $ $ $ $ *@* $ $ $ $ $  ##
## ..*.....*...$...*.....*.. ##
 # ###$ $ $ $ $.$ $ $ $ $### #
 # ## .*.*.*.*.$.*.*.*.*. ## #
 #*#  $ ### $  #  $ ### $  #*#
 # $ $ ### $  ###  $ ### $ $ #
 #  $ ### $  #####  $ ### $  #
 #         *   *   *         #
 #############################